############
#O       O #
#  P    ####
#          #
#######    #
#   O##    #
#    ##    #
#    ##    #
# X        #
#       XX #
#     #    #
############
